1111111111
1C0C001001
10P0E100C1
100C000001
1111111111