1111111111
10000000P1
1E0C000001
1111111111